01010101010101010101010101010101010101010101010101
00000000000000000000000000000000000000000000000000
10000000000000000000000000000000000000000000000001
00000000000000000000000000000000000000000000000000
10111111111111111111111111111111111111111111111110
00111111111111111111111111111111111111111111111111
10111111111111111111111111111111111111111111111110
00000000000000000000000000000000000000000000000000
10000000000000000000000000000000000000000000000001
00000000000000000000000000000000000000000000000000
10000000000000000000000000000000000000000000000001
00000000000000000000000000000000000000000000000000
10000000000000000000000000000000000000000000000001
00000000000000000000000000000000000000000000000000
10101010101010101010110101010101010101010101010101
00000000000000000000000000000000000000000000000001
00000000000000000000000000000000000000000000000000
00000000000000000000000000000000000000000000000001
00000000000000000000000000000000000000000000000000
00000000000000000000000000000000000000000000000001
00000000000000000000000000000000000000000000000000
00000000000000000000000000000000000000000000000001
00000000000000000000000000000000000000000000000000
00000000000000000000000000000000000000000000000001
00000000000000000000000000000000000000000000000000
00000000000000000000000000000000000000000000000001
00000000000000000000000000000000000000000000000000
00000000000000000000000000000000000000000000000001
00000000000000000000000000000000000000000000000000
00000000000000000000000000000000000000000000000001
00000000000000000000000000000000000000000000000000
00000000000000000000000000000000000000000000000001
00000000000000000000000000000000000000000000000000
00000000000000000000000000000000000000000000000001
00000000000000000000000000000000000000000000000000
00000000000000000000000000000000000000000000000001
00000000000000000000000000000000000000000000000000
00000000000000000000000000000000000000000000000001
00000000000000000000000000000000000000000000000000
00000000000000000000000000000000000000000000000001
00000000000000000000000000000000000000000000000000
00000000000000000000000000000000000000000000000001
00000000000000000000000000000000000000000000000000
00000000000000000000000000000000000000000000000001
00000000000000000000000000000000000000000000000000
00000000000000000000000000000000000000000000000001
00000000000000000000000000000000000000000000000000
00000000000000000000000000000000000000000000000000
00000000000000000000000000000000000000000000000001
10101010101010101010101010101010101010101010101010
