00000000000000000000
00000000000000000000
00000000000000000000
00000011000000000000
00000011000000000000
00000011000000000000
00000011000000000000
00000011111111000000
00000011111111000000
00000011000010000000
00000011000010000000
00000000000010000000
00000000000010000000
00001111111110000000
00000000000010000000
00000000000010000000
00000000000000000000
00000000000000000000
00000000000000000000
00000000000000000000
